w w w w w w w w w w w w w w w w w w w w w w w w w w w w w w w w 
w w w w w w w w w w w w w w w w w w w w w w w w w w w w w w w w 
w w w w w f f f f f f f f f f f f f f f f f f f f f f w w w w w 
w w w w w f w w w w w f w w f w w f w w f w w w w w f w w w w w 
w w w w w f w w w w w f w w f w w f w w f w w w w w f w w w w w 
w w f f f f f f f w w f w w f w w f w w f w w f f f f f f f w w 
w w f w w w w w f w w u w w f w w f w w f w w f w w w w w f w w 
w w f w w w w w f w w f w w f w w f w w f w w f w w w w w f w w 
w w f f f f f f f w w f w w f w w f w w f w w f f f f f f f w w 
w w f w w w w w f w w f w w f w w f w w f w w f w w w w w f w w 
w w f w w w w w f w w f w w f w w f w w f w w f w w w w w f w w 
w w f f f f f f f f f f f f f f f f f f f f f f f f f p f f w w 
w w w w w f w w w w w f w w w w w w w w f w w w w w f w w w w w 
w w w w w f w w w w w f w w w w w w w w f w w w w w f w w w w w 
w w w w w f w w f f f f f f f w w f f f f f f f w w f w w w w w 
w w w w w f w w f w w w w w f w w f w w w w w f w w f w w w w w 
w w w w w f w w f w w w w w f w w f w w w w w f w w f w w w w w 
w w w w w f f f f f f f f f f w w f f f f f f f f f f w w w w w 
w w w w w f w w w w w w w w f w w f w w w w w w w w f w w w w w 
w w w w w f w w w w w w w w f w w f w w w w w w w w f w w w w w 
w w f f f f f f f f f f w w f f f f w w f f f f f f f f f f w w 
w w f w w w w w f w w f w w f w w f w w x w w f w w w w w f w w 
w w f w w w w w f w w f w w f w w f w w f w w f w w w w w f w w 
w w f f f f f f f f f f f f f f f f f f f f f f f f f f f f w w 
w w f w w w w w w w w w w w f w w f w w w w w w w w w w w f w w 
w w f w w w w w w w w w w w f w w f w w w w w w w w w w w f w w 
w w f f f f f f f f f f f f f w w f f f f f f f f f f f f f w w 
w w f w w w w w f w w f w w w w w w w w f w w f w w w w w f w w 
w w f w w w w w f w w f w w w w w w w w f w w f w w w w w f w w 
w w f f f f f f f f f f f f f f f f f f f f f f f f f f f f w w 
w w w w w w w w w w w w w w w w w w w w w w w w w w w w w w w w 
w w w w w w w w w w w w w w w w w w w w w w w w w w w w w w w w 
