w w w w w w w w w w w w w w w w w w w w w w w w w w w w w w w w 
w w w w w w w w w w w w w w w w w w w w w w w w w w w w w w w w 
w w f f f f f f f f f f f f f f f f f f f f f f f f f f f f w w 
w w f w w w w w f w w w w w f w w f w w w w w f w w w w w f w w 
w w f w w w w w f w w w w w f w w f w w w w w f w w w w w f w w 
w w f f f f f f f f f f w w f w w f w w f f f f f f f f f f w w 
w w f w w w w w w w w f w w f w w f w w f w w w w w w w w f w w 
w w f w w w w w w w w f w w f w w f w w f w w w w w w w w f w w 
w w f f f f f f f f f f w w f w w f w w f f f f f f f f f f w w 
w w f w w w w w w w w f w w f w w f w w f w w w w w w w w f w w 
w w f w w w w w w w w f w w f w w f w w f w w w w w w w w f w w 
w w f f f f f f f f f f f f f f f f f f f f f f f f f f f f w w 
w w f w w w w w w w w w w w w w w w w w w w w w w w w w w f w w 
w w f w w w w w w w w w w w w w w w w w w w w w w w w w w f w w 
w w f f f f f f f f f f f f x f f f f f f f f f f f f f f f w w 
w w w w w f w w f w w f w w w w w w w w f w w f w w f w w w w w 
w w w w w f w w f w w f w w w w w w w w f w w f w w f w w w w w 
w w w w w f w w f w w f w w f f f f w w f w w f w w f w w w w w 
w w w w w f w w f w w f w w f w w f w w f w w f w w f w w w w w 
w w w w w f w w f w w f w w f w w f w w f w w f w w f w w w w w 
w w f f f p w w f w w f w w f w w f w w f w w f w w f f f f w w 
w w f w w w w w f w w f w w f w w f w w f w w f w w w w w f w w 
w w f w w w w w f w w f w w f w w f w w f w w f w w w w w f w w 
w w f f f f f f f f f f f f f w w f f f f f f f f f f f f f w w 
w w f w w w w w f w w w w w w w w w w w w w w f w w w w w f w w 
w w f w w w w w f w w w w w w w w w w w w w w f w w w w w f w w 
w w f f f f f f f f f f f u f w w f f f f f f f f f f f f f w w 
w w f w w w w w w w w f w w f w w f w w f w w w w w w w w f w w 
w w f w w w w w w w w f w w f w w f w w f w w w w w w w w f w w 
w w f f f f f f f f f f f f f f f f f f f f f f f f f f f f w w 
w w w w w w w w w w w w w w w w w w w w w w w w w w w w w w w w 
w w w w w w w w w w w w w w w w w w w w w w w w w w w w w w w w 
