w w w w w w w w w w w w w w w w w w w w w w w w w w w w w w w w 
w w w w w w w w w w w w w w w w w w w w w w w w w w w w w w w w 
w w f f f f f f f f f f f f f f f f f f f f f f f f f f f f w w 
w w f w w w w w w w w f w w f w w f w w f w w w w w w w w f w w 
w w f w w w w w w w w f w w f w w f w w f w w w w w w w w f w w 
w w f f f f f f f w w f w w f w w f w w f w w f f f f f f f w w 
w w f w w w w w f w w f w w f w w f w w f w w f w w w w w f w w 
w w f w w w w w f w w f w w f w w f w w f w w f w w w w w f w w 
w w f f f f f f f f f f f f f w w f u f f f f f f f f f f f w w 
w w w w w f w w f w w w w w f w w f w w w w w f w w f w w w w w 
w w w w w f w w f w w w w w f w w f w w w w w f w w f w w w w w 
w w f f f f w w f f f f w w f w w f w w x f f f w w f f f f w w 
w w f w w w w w f w w f w w f w w f w w f w w f w w w w w f w w 
w w f w w w w w f w w f w w f w w f w w f w w f w w w w w f w w 
w w f f f f f f f f f f w w f f f f w w f f f f f f f f f f w w 
w w f w w w w w w w w f w w f w w f w w f w w w w w w w w f w w 
w w f w w w w w w w w f w w f w w f w w f w w w w w w w w f w w 
w w f f f f f f f f f f f f f f f f f f f f f f f f f f f f w w 
w w f w w w w w f w w w w w w w w w w w w w w f w w w w w f w w 
w w f w w w w w f w w w w w w w w w w w w w w f w w w w w f w w 
w w f f f f w w f f f f f f f w w f f f f f f f w w f p f f w w 
w w w w w f w w f w w f w w f w w f w w f w w f w w f w w w w w 
w w w w w f w w f w w f w w f w w f w w f w w f w w f w w w w w 
w w f f f f f f f w w f f f f w w f f f f w w f f f f f f f w w 
w w f w w w w w f w w f w w f w w f w w f w w f w w w w w f w w 
w w f w w w w w f w w f w w f w w f w w f w w f w w w w w f w w 
w w f f f f f f f f f f f f f f f f f f f f f f f f f f f f w w 
w w f w w w w w f w w w w w w w w w w w w w w f w w w w w f w w 
w w f w w w w w f w w w w w w w w w w w w w w f w w w w w f w w 
w w f f f f f f f f f f f f f f f f f f f f f f f f f f f f w w 
w w w w w w w w w w w w w w w w w w w w w w w w w w w w w w w w 
w w w w w w w w w w w w w w w w w w w w w w w w w w w w w w w w 
