w w w w w w w w w w w w w w w w w w w w w w w w w w w w w w w w 
w w w w w w w w w w w w w w w w w w w w w w w w w w w w w w w w 
w w f f f f f f f f f f f f f f f f f f f f f f f f f f f f w w 
w w f w w w w w w w w f w w w w w w w w f w w w w w w w w f w w 
w w f w w w w w w w w f w w w w w w w w f w w w w w w w w f w w 
w w f f f f f f f w w f f f f w w f f f f w w f f f f f f f w w 
w w w w w f w w f w w f w w f w w f w w f w w f w w f w w w w w 
w w w w w f w w f w w f w w f w w f w w p w w f w w f w w w w w 
w w w w w f w w f f f f f f f w w f f f f f f f w w f w w w w w 
w w w w w f w w f w w w w w f w w f w w w w w f w w f w w w w w 
w w w w w f w w f w w w w w f w w f w w w w w f w w f w w w w w 
w w f f f f w w f w w f f f f w w f f f f w w f w w f u f f w w 
w w f w w w w w f w w f w w f w w f w w f w w f w w w w w f w w 
w w f w w w w w f w w f w w f w w f w w f w w f w w w w w f w w 
w w f f f f f f f f f f w w f f f f w w f f f f f f f f f f w w 
w w w w w f w w f w w w w w f w w f w w w w w f w w f w w w w w 
w w w w w f w w f w w w w w f w w f w w w w w f w w f w w w w w 
w w f f f f f f f f f f w w f w w f w w f f f f f f f f f f w w 
w w f w w w w w w w w f w w f w w f w w f w w w w w w w w f w w 
w w f w w w w w w w w f w w f w w f w w f w w w w w w w w f w w 
w w f f f f w w f f f f f f f w w f f f f f f f w w f f f f w w 
w w w w w f w w f w w f w w w w w w w w f w w f w w f w w w w w 
w w w w w f w w f w w f w w w w w w w w f w w f w w f w w w w w 
w w f f f f f f f w w f f f f f f f f f f w w f f f f f f f w w 
w w f w w w w w f w w f w w f w w f w w f w w f w w w w w f w w 
w w f w w w w w f w w f w w f w w f w w f w w f w w w w w f w w 
w w f f f f w w f w w f f f f f f f f f f w w f w w f f f f w w 
w w w w w f w w f w w f w w w w w w w w f w w f w w f w w w w w 
w w w w w f w w f w w f w w w w w w w w f w w f w w x w w w w w 
w w w w w f f f f f f f f f f f f f f f f f f f f f f w w w w w 
w w w w w w w w w w w w w w w w w w w w w w w w w w w w w w w w 
w w w w w w w w w w w w w w w w w w w w w w w w w w w w w w w w 
