w w w w w w w w w w w w w w w w w w w w w w w w w w w w w w w w 
w w w w w w w w w w w w w w w w w w w w w w w w w w w w w w w w 
w w f f f f f f f f f f f f f f f f f f f f f f f f f f f f w w 
w w f w w w w w f w w f w w w w w w w w f w w f w w w w w f w w 
w w f w w w w w f w w f w w w w w w w w f w w f w w w w w f w w 
w w f w w w w w f f f f f f f w w f f f f f f f w w w w w f w w 
w w f w w w w w f w w w w w f w w f w w w w w f w w w w w f w w 
w w f w w w w w f w w w w w f w w f w w w w w f w w w w w f w w 
w w f f f f f f f f f f f f f w w f f f f f f f f f f f f f w w 
w w f w w w w w w w w w w w f w w f w w w w w w w w w w w f w w 
w w f w w w w w w w w w w w f w w f w w w w w w w w w w w f w w 
w w f f f f f f f f f f f f f f f f f f f f f f f f f f f f w w 
w w w w w f w w f w w f w w w w w w w w f w w f w w f w w w w w 
w w w w w f w w f w w f w w w w w w w w f w w f w w f w w w w w 
w w f f f f w w f f f f w w f f f f w w u f x f w w f f f f w w 
w w f w w w w w f w w f w w f w w f w w f w w f w w w w w f w w 
w w f w w w w w f w w f w w f w w f w w f w w f w w w w w f w w 
w w f f f f f f f w w f w w f f f f w w f w w f f f f f f f w w 
w w f w w w w w f w w f w w f w w f w w f w w f w w w w w f w w 
w w f w w w w w f w w f w w f w w f w w f w w f w w w w w f w w 
w w f f f f w w f w w f w w f w w f w w f w w f w w f f f f w w 
w w w w w f w w f w w f w w f w w f w w f w w f w w f w w w w w 
w w w w w f w w f w w f w w f w w f w w f w w f w w f w w w w w 
w w w w w f w w f w w f f f f w w f f f f w w f w w f w w w w w 
w w w w w f w w f w w f w w f w w f w w f w w f w w f w w w w w 
w w w w w f w w f w w f w w f w w f w w f w w f w w f w w w w w 
w w w w w f f f f f f f w w f w w f w w f p f f f f f w w w w w 
w w w w w f w w w w w w w w f w w f w w w w w w w w f w w w w w 
w w w w w f w w w w w w w w f w w f w w w w w w w w f w w w w w 
w w w w w f f f f f f f f f f f f f f f f f f f f f f w w w w w 
w w w w w w w w w w w w w w w w w w w w w w w w w w w w w w w w 
w w w w w w w w w w w w w w w w w w w w w w w w w w w w w w w w 
