w w w w w w w w w w w w w w w w w w w w w w w w w w w w w w w w 
w w w w w w w w w w w w w w w w w w w w w w w w w w w w w w w w 
w w f f f f f f f f f f f f f f f f f f f f f f f f x f f f w w 
w w f w w w w w w w w f w w w w w w w w f w w w w w w w w f w w 
w w f w w w w w w w w f w w w w w w w w f w w w w w w w w f w w 
w w f f f f f f f f f f f f f w w f f f f f f f f f f f f f w w 
w w w w w f w w w w w w w w f w w f w w w w w w w w f w w w w w 
w w w w w f w w w w w w w w f w w f w w w w w w w w f w w w w w 
w w f f f f f f f f f f f f f w w f f f f f f f f f f f f f w w 
w w f w w w w w f w w w w w f w w f w w w w w f w w w w w f w w 
w w f w w w w w f w w w w w f w w f w w w w w f w w w w w f w w 
w w f f f f f f f f f f f f f f f f f f f f f f f f f f f f w w 
w w w w w f w w w w w w w w w w w w w w w w w w w w f w w w w w 
w w w w w f w w w w w w w w w w w w w w w w w w w w f w w w w w 
w w f f f f f f f f f f f f f f f f f f f f f f f f p f f f w w 
w w f w w w w w f w w f w w w w w w w w f w w f w w w w w f w w 
w w f w w w w w f w w f w w w w w w w w f w w f w w w w w f w w 
w w f f f f w w f w w f w w f f f f w w f w w f w w f f f f w w 
w w w w w f w w f w w f w w f w w f w w f w w f w w f w w w w w 
w w w w w f w w f w w f w w f w w f w w f w w f w w f w w w w w 
w w w w w f w w f w w f f f f w w u f f f w w f w w f w w w w w 
w w w w w f w w f w w f w w f w w f w w f w w f w w f w w w w w 
w w w w w f w w f w w f w w f w w f w w f w w f w w f w w w w w 
w w w w w f w w f w w f w w f w w f w w f w w f w w f w w w w w 
w w w w w f w w f w w f w w f w w f w w f w w f w w f w w w w w 
w w w w w f w w f w w f w w f w w f w w f w w f w w f w w w w w 
w w w w w f f f f f f f w w f w w f w w f f f f f f f w w w w w 
w w w w w f w w w w w w w w f w w f w w w w w w w w f w w w w w 
w w w w w f w w w w w w w w f w w f w w w w w w w w f w w w w w 
w w w w w f f f f f f f f f f f f f f f f f f f f f f w w w w w 
w w w w w w w w w w w w w w w w w w w w w w w w w w w w w w w w 
w w w w w w w w w w w w w w w w w w w w w w w w w w w w w w w w 
